10 10
_ _______
| |_____|
|      ||
|____| _|
|_ __| _|
||   | ||
||      |
||   |_ |
||   || |
||___|| |