6 16
_ _____________
|   | |     |||
|__ |   |||  ||
| |       || ||
| |    |||||
|_|____||||_|||