14 31
_ ____________________________
|   | |     ||       ||     ||
|__ |   |||  |||  ||  |  || ||
| |       || |||| |___|  || ||
| |    |||||      |  ||| |   |
|_|____||||_||||| |_ __| |   |
|||   | |   |   |  |  |  | | |
|_| |_|   |   |    ||   || | |
|_| |_| |   |   |  |||| || |_|
|_      _____||____|    ||  ||
|                    ||||__ ||
|_|_____||_______|____|||_| ||
|                            |
|__| _________________|||__|||